aromatic — ароматный
bitter — горький
blunt — тупой
calm — тихий
cold — холодный
concave — впалый; вогнутый
conic — конический
convex — выпуклый
cool — прохладный
cubic — кубический
curved — кривой
cylindrical — цилиндрический
deaf — глухой
deep — глубокий
dry — сухой
even — ровный
far — далекий
fine — мелкий ; тонкий ; изящный
flat— плоский
plane — плоский
fragrant — душистый
fresh — свежий
hard — твердый
hardly audible — еле слышный
horizontal — горизонтальный
hot — горячий
huge — огромный
humid — влажный
inclined — наклонный
large— большой
big — большой
little
small — маленький
long — длинный
loud — громкий
low — низкий
low — тихий ; низкий
medium-sized — среднего размера
muffled — приглушенный
narrow — узкий
near — близкий
noisy — шумный
odourless — без запаха
oval — овальный
pleasant — приятный
pungent — острый
quiet — тихий
rectangular — прямоугольный
rough — шероховатый
round — круглый
salty — соленый
shallow — мелкий
sharp — острый
sharp — резкий
short — короткий
smelly — неприятно пахнущий
smooth — гладкий
soft — мягкий
soft — тихий ; нежный
sour — кислый
specific — специфический
spherical — сферический
square — квадратный
stinking — вонючий
straight — прямой
strong — крепкий
sweet — сладкий
tall — высокий
tasteless — безвкусный
tasty, delicious — вкусный
thick — толстый
thin — тонкий
triangular — треугольный
uneven — неровный
unpleasant — неприятный
vertical — вертикальный
warm — теплый
wet — мокрый
wide, broad — широкий
abominable — отвратительный
agitated — взволнованный
angry, cross — сердитый
angst -ridden — испуганный
appalled — напуганный, потрясенный
astonished — изумленный
awed — трепещущий
awful, terrible — ужасный
bad — плохой
beautiful, lovely — красивый
bored — скучающий
boring — надоедливый
cheerful — веселый
cheery, mirthful — радостный
contented — довольный
dangerous — опасный
dejected — угнетенный
delightful — восхищенный, удовлетворенный
disgusting, unpleasant — неприятный
distressed — расстроенный
disturbing — тревожный ; вызывающий беспокойство
doubtful — сомневающийся
dreamy — мечтательный, витающий в облаках
excellent — отличный
excited — возбужденный
excited, agitated, uneasy — взволнованный
exciting, moving — волнующий
fearful — страшный
fearful — испуганный, боящийся
frightened — напуганный
frightened, scared — испуганный
fuming — яростный
giggly — хихикающий
glad — довольный
good — хороший
guilty — виноватый
haggard — изможденный
handsome — симпатичный (о мужчине)
happy — счастливый
high-spirited — в хорошем настроении
horrified — напуганный
hurt — обиженный
hysterical — истеричный
infuriated — разъяренный
insulting, abusive, offensive — оскорбительный
interesting — интересный
joyful, merry — радостный
lovey-dovey — шаловливый, игривый, влюбленный (AmE)
low-spirited — в плохом настроении
lucky — везучий
moved — растроганный
nice — милый
normal — обычный
offended — оскорбленный
optimistic — оптимистический
peevish — сварливый
perfect — совершенный
pessimistic — пессимистический
pleasant, agreeable — приятный
pretty, attractive — привлекательный
repulsive — отталкивающий
sad — печальный
sarcastic — саркастический, язвительный
satisfied — удовлетворенный
self-disgusted — вызывающий отвращение к себе
shocked — шокированный
shocking — шокирующий
sorrowful — горестный
sorry — огорченный
splendid, gorgeous, magnificent — великолепный
startled — пораженный, сильно удивленный
strange — странный
stuffed — объевшийся
stunned — ошеломленый
superior — превосходный
surprised — удивленный
surprised, astonished, amazed — удивленный
surprising, astonishing, amazing — удивительный
terrified — испуганный
tiresome — скучный
touching — трогательный
ugly — безобразный
unattractive — непривлекательный
unhappy — несчастливый
upset — расстроенный
wonderful — чудесный
woozy — одурманенный
worried — обеспокоенный
baked — печеный
busy — занятый (чем-либо)
cheerful — бодрый
clean — чистый
comfortable, convenient — удобный
complete — завершенный
cooked — приготовленный (о пище)
damaged — поврежденный
dirty — грязный
divorced — разведенный
drowsy, sleepy — сонливый
emaciated — исхудалый
engaged — занятый
exhausted — очень усталый
fat — жирный
free — свободный
fried — жареный
full — сытый
grown-up — взрослый
healthy — здоровый
hungry — голодный
in good repair — в хорошем состоянии
incomplete — незавершенный ; неполный
intact — исправный
lean — худощавый
married — женатый ; замужем
mature — зрелый
occupied — занятый (о месте)
packed up — упакованный
pregnant — беременная
ragged — оборванный
raw — сырой (невареный)
ready — готовый
rich — богатый
robust — крепкий, здоровый; сильный
sick, ill — больной
single — неженатый
slim — стройный
spoilt — испорченный
strong — сильный
thirsty — жаждущий
tired — усталый
uncomfortable, inconvenient — неудобный
vacant — свободный ; вакантный
vigorous — энергичный ; сильный
weak — слабый
well-dressed — хорошо одетый
well-to-do — благосостоятельный
young — молодой
arrogant — высокомерный
boastful — хвастливый
brave — храбрый
bright — способный
broad-minded — с широким кругозором
calculating — расчетливый
calm — спокойный
can-do — исполнительный
cold — холодный
competitive — конкурентоспособный
confident — уверенный
considerate — внимательный
cooperative — отзывчивый
cooperative — сотрудничающий
creative — творческий
cunning — хитрый
curious — любопытный
curious — любопытный
decent — порядочный
depressed — подавленный, унылый
emotional — эмоциональный
enterprising — предприимчивый
faithful — верный
friendly — дружелюбный
good-natured — хороший характер, добродушный
greedy — жадный
guilty — виновный
hard-headed — твердолобый
hard-working — трудолюбивый
honest — честный
hospitable — гостеприимный
hot-tempered — вспыльчивый
impudent — нахальный
incorruptible — неподкупный
irritable — раздражительный
lonely — одинокий
modest — скромный
nervous — нервный
observant — наблюдательный
obstinate — упрямый
optimistic — оптимистичный
outgoing — тусовщик
persistent — настойчивый
practical — практичный
pretty — милая, прелестная (о женщине)
purposeful — целеустремленный
quick witted — находчивый
quiet — тихий
reserved — сдержанный
reserved — сдержанный
respectful — почтительный
responsible — ответственный
sad — печальный
sceptical — скептический
self-confident — самоуверенный
self-possessed — выдержанный, хладнокровный
selfish — эгоистичный
serious — серьезный
shy — застенчивый
sociable — общительный, коммуникабельный
sociable — общительный
stable — стабильный
talkative — разговорчивый
tolerant — терпимый
tough — жесткий
traditional — традиционный
trusting — доверчивый
warm — милый (о мужчине)
absurd — абсурдный
acceptable — приемлемый
advanced — передовой ; продвинутый
appropriate, suitable — подходящий
approximate — приблизительный
artificial — искусственный
average — средний
correct — правильный
defective — дефектный
different, various — различный
difficult — трудный
easy — легкий
empty — пустой
equal — равный ; одинаковый
essential — существенный
excessive — избыточный
false — ложный
full — полный
high-quality — качественный
illegal — незаконный
illogical — нелогичный
important — важный
inappropriate, out of place — неуместный
inferior — уступающий
insignificant — незначительный
insufficient — недостаточный
legal, lawful — законный
logical — логичный
maximum — максимальный
minimum — минимальный
natural — естественный
non-standard — нестандартный
not numerous — немногочисленный
numerous — многочисленный
optimum — оптимальный
precise — точный
redundant — лишний ; избыточный
rejected — забракованный
reliable — надежный
satisfactory — удовлетворительный
significant — значительный
similar — похожий
sophisticated — усовершенствованный
spoiled — испорченный
standard — стандартный
sufficient — достаточный
superfluous — лишний
the same — тот же самый
true — верный
unreliable — ненадежный
wrong — неправильный
absolute — абсолютный
actual — фактический
advantageous — выгодный
basic — основной
certain — определенный
cheap — дешевый
common, general — общий
complex — сложный
conditional — условный
desirable — желательный
disadvantageous — невыгодный
efficient — эффективный
expensive — дорогой
fantastic — фантастический
free of charge — бесплатный
harmful — вредный
harmless — безвредный
hypothetical, assumed — предполагаемый
imaginary — воображаемый
inevitable — неизбежный
invalid — недействительный
main, chief, principal — главный
necessary — необходимый
negative — отрицательный
occasional — случайный
particular — особенный
positive — положительный
possible, probable — возможный
practical — практический
priceless — бесценный
profitable — доходный
real — реальный
regular — закономерный
relative — относительный
secondary — второстепенный
separate — отдельный
simple — простой
single — единичный
special — специальный
theoretical — теоретический
typical — типичный
unprofitable — недоходный
useful — полезный
useless — бесполезный
valid — действительный (в силе)
absent-minded, distracted — рассеянный
accurate — аккуратный
attentive, careful — внимательный
average — средний
capable — способный
careless — невнимательный
clever, intelligent — умный
clumsy, awkward — неуклюжий
crazy — сумасшедший; чокнутый
deft, dexterous — ловкий
diligent — прилежный
dull, dim-witted — тупой
erudite — эрудированный
exact — точный
experienced — опытный
gifted — одаренный
great — гениальный
high-skilled — высококвалифицированный
ignorant — незнающий
industrious — усердный
inexperienced — неопытный
lazy — ленивый
mad — сумасшедший
mediocre — посредственный
naive — наивный
negligent — небрежный
quick — находчивый
sharp-witted — остроумный
silly, stolid, stupid — глупый
skilful — умелый
sly — хитрый
talented — талантливый
thorough — тщательный
unskilful — неумелый
wise — мудрый
adult — взрослый
aged — пожилой
ancient — древний
brief — краткий
constant — постоянный
contemporary, modem — современный
continuous — длящийся
early — ранний
eternal, everlasting — вечный
fast, swift, quick — быстрый
final — конечный
frequent — частый
future — будущий
gradual — постепенный
infrequent — нечастый
initial — начальный
late — поздний
little — маленький
long — долгий
next, following — следующий
obsolete — устаревший
occasional — случайный
old — старый
past — прошлый
periodical — периодический
preceding — предшествующий
preliminary — предварительный
present — настоящий
previous — предыдущий
provisional, temporary — временный
rapid — стремительный
rare — редкий
recent — недавний
short — короткий
simultaneous — одновременный
slow — медленный
sudden — внезапный
the first — первый
the last — последний
uninterrupted — непрерывный
up-to-date — новейший
urgent — срочный
usual — обычный
young — молодой