aunt : тетя
baby : грудной ребенок
boyfriend : возлюбленный; молодой человек
brother : брат
brother-in-law : зять (муж сестры) ; шурин (брат жены);свояк (муж свояченицы);деверь (брат мужа)
child : ребенок
kid : ребенок
children  : дети
kids : дети
cousin : двоюродный брат; двоюродная сестра
dad : папа
daddy : папа
daughter : дочь
daughter-in-law : невестка; сноха (жена сына)
father : отец
father-in-law : свекор (отец мужа); тесть (отец жены)
fiancé : жених
groom : жених
bridegroom : жених
fiancée : невеста
bride : невеста
folks  : семья
family : семья
foster child : приемыш
foster father : приемный отец
foster mother : приемная мать
girlfriend : возлюбленная; девушка
godchild : крестник; крестница
goddaughter : крестница
godfather : крестный отец
godmother : крестная мать
godson : крестник
grandchild : внук; внучка
granddad : разг. дедушка
grandpa : разг. дедушка
gramps : разг. дедушка
granddaughter : внучка
grandfather : дедушка
grandma : разг. бабушка
granny : разг. бабушка
grams : разг. бабушка
grandmother : бабушка
grandson : внук
great granddaughter : правнучка
great grandfather : прадед
great grandmother : прабабушка
great grandson : правнук
husband : муж
maternal grandfather : дедушка по линии матери
maternal grandmother : бабушка по линии матери
mother : мать
mother-in-law : свекровь (мать мужа); теща (мать жены)
mum : мама
mummy : мама
mom : мама
nephew : племянник
niece : племянница
parents : родители
paternal grandfather : дедушка по линии отца
paternal grandmother : бабушка по линии отца
relatives : родственники
sister : сестра
sister-in-law : невестка (жена брата) ; золовка (сестра мужа) ; свояченица (сестра жены)
son : сын
son-in-law : зять (муж дочери)
spouse : супруг; супруга
stepbrother : сводный брат
half brother : сводный брат
stepchild : пасынок; падчерица
stepdaughter : падчерица
stepfather : отчим
stepmother : мачеха
stepsister : сводная сестра
half sister : сводная сестра
stepson : пасынок
uncle : дядя
wife : жена
adop : усыновлять; удочерять
adult : взрослый человек
grown-up : взрослый человек
ancestor : предок
bachelor : холостяк
baptize : крестить
be engaged : быть помолвленным
be in love : быть влюбленным
be married to : быть женатым на; бать замужем за
be pregnant : быть беременной
birthday : день рождения
born : рожденный
bring up : воспитывать
raise : воспитывать
couple : пара (супружеская)
descendant : потомок
divorced : разведенный
expect a baby : ожидать ребенка
fall in love : влюбиться
give birth to (somebody) : родить (кого-либо)
go to school : ходить в школу
guardian : опекун; попечитель
marry : жениться; выйти замуж
get married : жениться; выйти замуж
orphan : сирота
spinster : старая дева; незамужняя женщина
teenager : подросток
wedding : свадьба
widow : вдова
widowed : овдовевший
widower : вдовец
youth : юноша; молодой человек ; юность; молодость